1,0,1,4,1
4,2,0,2,0
1,0,3,0,0
0,2,0,2,0
1,4,0,4,1